NO ./assets/wolfenstein/bluestone.xpm
SO ./assets/wolfenstein/eagle.xpm
WE ./assets/wolfenstein/purplestone.xpm
EA ./assets/wolfenstein/wood.xpm

F 30,100,40
C 55,100,250

111111
100101
101001
1100N1
111111
