NO ./assets/wolfenstein/bluestone.xpm
SO ./assets/wolfenstein/eagle.xpm
WE ./assets/wolfenstein/purplestone.xpm
EA ./assets/wolfenstein/wood.xpm

F 30,100,40
C 55,100,250

111111
100001
100000111
100N01
111111
